##########
#........#
#.##.###.@
#..#.#...#
####.#.###
#....#...#
########.#
#........#
#.########
#.........
##########