####@####
#.......#
#.......#
#.......#
#.......#
#.......#
#.......#
#.......#
#.......!
#########