#####@#####
#.........#
#.........#
#.........#
#.........#
#.........#
#.........#
#.........#
#........!*
#........^%
###########