####@######
#.........#
#........!#
#!........#
#........!#
#!...^....#
#........!#
#!........#
#........!#
#.........#
###########
