...................................
...................................
...................................
...................................
....##########################.....
....#........................#.....
....#.####.#####.######.#....#.....
....#....#.#...#.#....#.#....#.....
....###..#.#.#.#.#.##.#.#*...#.....
....#@#..#.#.###.#.###########.....
....#.#..#.#...........#.....#.....
....#.#..#.###########.#.#####.....
....#.###............#.#......%....
....#.#....#..######.#.#.....#.....
....#.#####...#.#..#.#.###.###.....
....#.....#...#.#..#.#.......#.....
....#.###.#####.####.#########.....
....#........................#.....
....##########################.....
...................................
...................................
...................................
...................................
