..................................
..................................
..................................
..................................
....##########################....
....#........................#....
....#.####.#####.######.#....#....
....#....#.#...#.#....#.#....#....
....###..#.#.#.#.#.##.#.#....#....
....#@#..#.#.###.#.###########....
....#.#..#.#...........#.....#....
....#.#..#.###########.#.#####....
....#.###............#.#..........
....#.#....#..######.#.#.....#....
....#.#####...#.#..#.#.###.###....
....#.....#...#.#..#.#.......#....
....#.###.#####.####.#########....
....#........................#....
....##########################....
..................................
..................................
..................................
..................................
