...................................
...................................
...................................
...................................
....##########################.....
....#........................#.....
....#.####.#####.######.#....#.....
....#....#.#...#.#....#.#....#.....
....###..#.#.#.#.#.##.#*#*...#.....
....#@#..#.#.###.#.###########.....
....#.#..#.#...........#.....#.....
....#.#..#.###########.#.#####.....
....#.###............#.#......%....
....#.#....#..######.#.#.....#.....
....#.#####...#.#..#.#.###.###.....
....#.....#*..#.#..#.#.......#.....
....#.###*#####.####.#########.....
....#.......................*#.....
....##########################.....
...................................
...................................
...................................
...................................
