...................................
...................................
...................................
...................................
....##########################.....
....#........................#.....
....#.####.#####.######.#....#.....
....#....#.#...#.#....#.#....#.....
....###..#.#.#*#.#.##.#*#*...#.....
....#@#..#.#.###.#.###########.....
....#.#..#.#...........#.....#.....
....#.#.*#.###########.#.#####.....
....#.###............#.#......%....
....#.#....#..######.#.#.....#.....
....#.#####...#.#..#.#.###.###.....
....#.....#*..#.#..#.#.......#.....
....#.###*#####.####.#########.....
....#.......................*#.....
....##########################.....
...................................
...................................
...................................
...................................
